Classic
0-000-000-000-0
--0----$----0--
0-0-0-000-0-0-0
0---0--+--0---0
000-0-000-0-000
----0--0--0----
0-0-00-0-00-0-0
0+0---------0+0
0-000-000-000-0
-------0-------
0-0-00-$-00-0-0
0-0--0   0--0-0
0-00-0 ^ 0-00-0
--00-00000-00--
0-0----0----0-0
0---00-0-00---0
000-0--#--0-000
----0-0-0-0----
0-000-0+0-000-0
0-0---0-0---0-0
----000-000----
0-0----$----0-0
0-000-000-000-0